111111111111111111111111111111111111111111111111111111111111111111111111111111111111111111111111111111
1E0000000000000C00000C000000000000000000000000C00000C000000000000000000000000C00000C000000000000000001
101001010010000010100100000001010010010100100000101001000000010100100101001000001010010000000101000001
101001001010101000100100000001010010010010101010001001000000010100100100101010100010010000000101000001
101001001010101000100100000001010010010010101010001001000000010100100100101010100010010000000101000001
101001001010101000100100000001010010010010101010001001000000010100100100101010100010010000000101000001
101001001010101000100100000001010010010010101010001001000000010100100100101010100010010000000101000001
101001001010101000100100000001010010010010101010001001000000010100100100101010100010010000000101000001
101001001010101000100100000001010010010010101010001001000000010100100100101010100010010000000101000001
101001001010101000100100000001010010010010101010001001000000010100100100101010100010010000000101000001
101001001010101000100100000001010010010010101010001001000000010100100100101010100010010000000101000001
101001001010101000100100000001010010010010101010001001000000010100100100101010100010010000000101000001
101001001010101000100100000001010010010010101010001001000000010100100100101010100010010000000101000001
101001001010101000100100000001010010010010101010001001000000010100100100101010100010010000000101000001
101001001010101000100100000001010010010010101010001001000000010100100100101010100010010000000101000001
101001001010101000100100000001010010010010101010001001000000010100100100101010100010010000000101000001
101001001010101000100100000001010010010010101010001001000000010100100100101010100010010000000101000001
101001001010101000100100000001010010010010101010001001000000010100100100101010100010010000000101000001
101001001010101000100100000001010010010010101010001001000000010100100100101010100010010000000101000001
101001001010101000100100000001010010010010101010001001000000010100100100101010100010010000000101000001
101001001010101000100100000001010010010010101010001001000000010100100100101010100010010000000101000001
101001001010101000100100000001010010010010101010001001000000010100100100101010100010010000000101000001
1P0000000C00C00000000000000000000000000C00C00000000000000000000000000C00C00000000000000000000000000C01
111111111111111111111111111111111111111111111111111111111111111111111111111111111111111111111111111111
