1111111111111111111111111111111111
1E00000000000B0C00000C0B0000000001
1010010100100000101001000000010101
1010010B10101010001001000B00010101
1P0000000C00C000000B000000000000C1
100000000000C000000B000011000000C1
100000000C000000000B000000000000C1
100000000000C000000B000000110000C1
100000000C00C000000B011000000000C1
1111111111111111111111111111111111
