11111
10001
10P01
1C0E1
10001
11111