111111111
1000P0001
100E00001
1P000E001
111111111